8 2
SYMBL: -1
X: 15
Y: 17
26 25 24 23 22 21 20 19 18 17 16 15 14 13 12 13 14 
25 24 23 22 21 20 19 18 17 16 15 14 13 12 11 12 13 
24 23 22 21 20 19 18 17 16 15 14 13 12 11 10 11 12 
23 22 21 20 19 18 17 16 15 14 13 12 11 10 9 10 11 
22 21 20 19 18 17 16 15 14 13 12 11 10 9  8  9 10 
21 20 19 18 17 16 15 14 13 12 11 10 9  8  7  8  9  
20 19 18 17 16 15 14 13 12 11 10 9  8  7  6  7  8  
19 18 17 16 15 14 13 12 11 10 9  8  7  6  5  6  7  
18 17 -1 15 14 13 12 11 10 9  8  7  6  5  4  5  6  
17 16 15 14 13 12 11 10 9  8  7  6  5  4  3  4  5  
16 15 14 13 12 11 10 9  8  7  6  5  4  3  2  3  4  
15 14 13 12 11 10 9  8  7  6  5  4  3  2  1  2  3  
14 13 12 11 10 9  8  7  6  5  4  3  2  1 -2  1  2  
15 14 13 12 11 10 9  8  7  6  5  4  3  2  1  2  3  
16 15 14 13 12 11 10 9  8  7  6  5  4  3  2  3  4  
SIZE_F_X: 2
SIZE_F_Y: 1
*
*
9 2
SYMBL: -1
X: 15
Y: 17
24 23 22 21 20 19 18 17 16 15 14 13 12 11 11 12 13 
23 22 21 20 19 18 17 16 15 14 13 12 11 10 10 11 12 
22 21 20 19 18 17 16 15 14 13 12 11 10 9  9 10 11 
21 20 19 18 17 16 15 14 13 12 11 10 9  8  8  9 10 
20 19 18 17 16 15 14 13 12 11 10 9  8  7  7  8  9  
19 18 17 16 15 14 13 12 11 10 9  8  7  6  6  7  8  
18 17 16 15 14 13 12 11 10 9  8  7  6  5  5  6  7  
17 16 15 14 13 12 11 10 9  8  7  6  5  4  4  5  6  
16 15 -1 13 12 11 10 9  8  7  6  5  4  3  3  4  5  
15 14 -1 12 11 10 9  8  7  6  5  4  3  2  2  3  4  
14 13 12 11 10 9  8  7  6  5  4  3  2  1  1  2  3  
13 12 11 10 9  8  7  6  5  4  3  2  1 -2 -2  1  2  
13 12 11 10 9  8  7  6  5  4  3  2  1 -2 -2  1  2  
14 13 12 11 10 9  8  7  6  5  4  3  2  1  1  2  3  
15 14 13 12 11 10 9  8  7  6  5  4  3  2  2  3  4  
SIZE_F_X: 1
SIZE_F_Y: 2
**
9 2
SYMBL: -1
X: 15
Y: 17
23 22 21 20 19 18 17 16 15 14 13 12 11 10 11 12 13 
22 21 20 19 18 17 16 15 14 13 12 11 10 9 10 11 12 
21 20 19 18 17 16 15 14 13 12 11 10 9  8  9 10 11 
20 19 18 17 16 15 14 13 12 11 10 9  8  7  8  9 10 
19 18 17 16 15 14 13 12 11 10 9  8  7  6  7  8  9  
18 17 16 15 14 13 12 11 10 9  8  7  6  5  6  7  8  
17 16 15 14 13 12 11 10 9  8  7  6  5  4  5  6  7  
16 15 14 13 12 11 10 9  8  7  6  5  4  3  4  5  6  
15 14 -1 12 11 10 9  8  7  6  5  4  3  2  3  4  5  
14 13 -1 -1 10 9  8  7  6  5  4  3  2  1  2  3  4  
13 12 11 10 9  8  7  6  5  4  3  2  1 -2  1  2  3  
13 12 11 10 9  8  7  6  5  4  3  2  1 -2 -2  1  2  
13 12 11 10 9  8  7  6  5  4  3  2  1 -2 -2  1  2  
14 13 12 11 10 9  8  7  6  5  4  3  2  1  1  2  3  
15 14 13 12 11 10 9  8  7  6  5  4  3  2  2  3  4  
SIZE_F_X: 2
SIZE_F_Y: 2
*.
*.
9 2
SYMBL: -1
X: 15
Y: 17
22 21 20 19 18 17 16 15 14 13 12 11 10 9  9 10 11 
21 20 19 18 17 16 15 14 13 12 11 10 9  8  8  9 10 
20 19 18 17 16 15 14 13 12 11 10 9  8  7  7  8  9  
19 18 17 16 15 14 13 12 11 10 9  8  7  6  6  7  8  
18 17 16 15 14 13 12 11 10 9  8  7  6  5  5  6  7  
17 16 15 14 13 12 11 10 9  8  7  6  5  4  4  5  6  
16 15 14 13 12 11 10 9  8  7  6  5  4  3  3  4  5  
15 14 13 12 11 10 9  8  7  6  5  4  3  2  2  3  4  
16 15 -1 11 10 9  8  7  6  5  4  3  2  1  1  2  3  
15 14 -1 -1  9  8  7  6  5  4  3  2  1 -2 -2  1  2  
14 13 -1  9  8  7  6  5  4  3  2  1 -2 -2  1  2  3  
13 12 11 10 9  8  7  6  5  4  3  2  1 -2 -2  1  2  
13 12 11 10 9  8  7  6  5  4  3  2  1 -2 -2  1  2  
14 13 12 11 10 9  8  7  6  5  4  3  2  1  1  2  3  
15 14 13 12 11 10 9  8  7  6  5  4  3  2  2  3  4  
SIZE_F_X: 1
SIZE_F_Y: 3
.**
10 2
SYMBL: -1
X: 15
Y: 17
21 20 19 18 17 16 15 14 13 12 11 10 9  8  9 10 11 
20 19 18 17 16 15 14 13 12 11 10 9  8  7  8  9 10 
19 18 17 16 15 14 13 12 11 10 9  8  7  6  7  8  9  
18 17 16 15 14 13 12 11 10 9  8  7  6  5  6  7  8  
17 16 15 14 13 12 11 10 9  8  7  6  5  4  5  6  7  
16 15 14 13 12 11 10 9  8  7  6  5  4  3  4  5  6  
15 14 13 12 11 10 9  8  7  6  5  4  3  2  3  4  5  
14 13 12 11 10 9  8  7  6  5  4  3  2  1  2  3  4  
15 14 -1 10 9  8  7  6  5  4  3  2  1 -2  1  2  3  
15 14 -1 -1 -1  8  7  6  5  4  3  2  1 -2 -2  1  2  
14 13 -1  9  8  7  6  5  4  3  2  1 -2 -2  1  2  3  
13 12 11 10 9  8  7  6  5  4  3  2  1 -2 -2  1  2  
13 12 11 10 9  8  7  6  5  4  3  2  1 -2 -2  1  2  
14 13 12 11 10 9  8  7  6  5  4  3  2  1  1  2  3  
15 14 13 12 11 10 9  8  7  6  5  4  3  2  2  3  4  
SIZE_F_X: 2
SIZE_F_Y: 1
*
*
11 2
SYMBL: -1
X: 15
Y: 17
19 18 17 16 15 14 13 12 11 10 9  8  8  8  9 10 11 
18 17 16 15 14 13 12 11 10 9  8  7  7  7  8  9 10 
17 16 15 14 13 12 11 10 9  8  7  6  6  6  7  8  9  
16 15 14 13 12 11 10 9  8  7  6  5  5  5  6  7  8  
15 14 13 12 11 10 9  8  7  6  5  4  4  4  5  6  7  
14 13 12 11 10 9  8  7  6  5  4  3  3  3  4  5  6  
13 12 11 10 9  8  7  6  5  4  3  2  2  2  3  4  5  
12 11 10 9  8  7  6  5  4  3  2  1  1  1  2  3  4  
13 12 -1  8  7  6  5  4  3  2  1 -2 -2 -2  1  2  3  
14 13 -1 -1 -1  7  6  5  4  3  2  1  1 -2 -2  1  2  
15 14 -1  9  8  7  6  5  4  3  2  1 -2 -2  1  2  3  
14 13 -1 10 9  8  7  6  5  4  3  2  1 -2 -2  1  2  
13 12 11 10 9  8  7  6  5  4  3  2  1 -2 -2  1  2  
14 13 12 11 10 9  8  7  6  5  4  3  2  1  1  2  3  
15 14 13 12 11 10 9  8  7  6  5  4  3  2  2  3  4  
SIZE_F_X: 1
SIZE_F_Y: 2
**
11 3
SYMBL: -1
X: 15
Y: 17
17 16 15 14 13 12 11 10 9  8  7  7  8  8  9 10 11 
16 15 14 13 12 11 10 9  8  7  6  6  7  7  8  9 10 
15 14 13 12 11 10 9  8  7  6  5  5  6  6  7  8  9  
14 13 12 11 10 9  8  7  6  5  4  4  5  5  6  7  8  
13 12 11 10 9  8  7  6  5  4  3  3  4  4  5  6  7  
12 11 10 9  8  7  6  5  4  3  2  2  3  3  4  5  6  
11 10 9  8  7  6  5  4  3  2  1  1  2  2  3  4  5  
10 9  8  7  6  5  4  3  2  1 -2 -2  1  1  2  3  4  
11 10 -1  7  6  5  4  3  2  1 -2 -2 -2 -2  1  2  3  
12 11 -1 -1 -1  6  5  4  3  2  1  1  1 -2 -2  1  2  
13 12 -1  9  8  7  6  5  4  3  2  1 -2 -2  1  2  3  
14 13 -1 -1  9  8  7  6  5  4  3  2  1 -2 -2  1  2  
13 12 11 10 9  8  7  6  5  4  3  2  1 -2 -2  1  2  
14 13 12 11 10 9  8  7  6  5  4  3  2  1  1  2  3  
15 14 13 12 11 10 9  8  7  6  5  4  3  2  2  3  4  
SIZE_F_X: 1
SIZE_F_Y: 3
**.
11 4
SYMBL: -1
X: 15
Y: 17
14 13 12 11 10 9  8  7  6  6  6  7  8  8  9 10 11 
13 12 11 10 9  8  7  6  5  5  5  6  7  7  8  9 10 
12 11 10 9  8  7  6  5  4  4  4  5  6  6  7  8  9  
11 10 9  8  7  6  5  4  3  3  3  4  5  5  6  7  8  
10 9  8  7  6  5  4  3  2  2  2  3  4  4  5  6  7  
9  8  7  6  5  4  3  2  1  1  1  2  3  3  4  5  6  
8  7  6  5  4  3  2  1 -2 -2 -2  1  2  2  3  4  5  
8  7  6  5  4  3  2  1 -2 -2 -2 -2  1  1  2  3  4  
9  8 -1  6  5  4  3  2  1  1 -2 -2 -2 -2  1  2  3  
10 9 -1 -1 -1  5  4  3  2  2  1  1  1 -2 -2  1  2  
11 10 -1  8  7  6  5  4  3  3  2  1 -2 -2  1  2  3  
12 11 -1 -1 -1  7  6  5  4  4  3  2  1 -2 -2  1  2  
13 12 11 10 9  8  7  6  5  4  3  2  1 -2 -2  1  2  
14 13 12 11 10 9  8  7  6  5  4  3  2  1  1  2  3  
15 14 13 12 11 10 9  8  7  6  5  4  3  2  2  3  4  
SIZE_F_X: 1
SIZE_F_Y: 2
**
11 5
SYMBL: -1
X: 15
Y: 17
12 11 10 9  8  7  6  5  5  5  6  7  8  8  9 10 11 
11 10 9  8  7  6  5  4  4  4  5  6  7  7  8  9 10 
10 9  8  7  6  5  4  3  3  3  4  5  6  6  7  8  9  
9  8  7  6  5  4  3  2  2  2  3  4  5  5  6  7  8  
8  7  6  5  4  3  2  1  1  1  2  3  4  4  5  6  7  
7  6  5  4  3  2  1 -2 -2 -2  1  2  3  3  4  5  6  
7  6  5  4  3  2  1 -2 -2 -2 -2  1  2  2  3  4  5  
8  7  6  5  4  3  2  1 -2 -2 -2 -2  1  1  2  3  4  
9  8 -1  6  5  4  3  2  1  1 -2 -2 -2 -2  1  2  3  
10 9 -1 -1 -1  5  4  3  2  2  1  1  1 -2 -2  1  2  
11 10 -1  8  7  6  5  4  3  3  2  1 -2 -2  1  2  3  
12 11 -1 -1 -1 -1  6  5  4  4  3  2  1 -2 -2  1  2  
13 12 11 10 9  8  7  6  5  4  3  2  1 -2 -2  1  2  
14 13 12 11 10 9  8  7  6  5  4  3  2  1  1  2  3  
15 14 13 12 11 10 9  8  7  6  5  4  3  2  2  3  4  
SIZE_F_X: 2
SIZE_F_Y: 2
**
..
11 6
SYMBL: -1
X: 15
Y: 17
11 10 9  8  7  6  5  5  5  5  6  7  8  8  9 10 11 
10 9  8  7  6  5  4  4  4  4  5  6  7  7  8  9 10 
9  8  7  6  5  4  3  3  3  3  4  5  6  6  7  8  9  
8  7  6  5  4  3  2  2  2  2  3  4  5  5  6  7  8  
7  6  5  4  3  2  1  1  1  1  2  3  4  4  5  6  7  
6  5  4  3  2  1 -2 -2 -2 -2  1  2  3  3  4  5  6  
7  6  5  4  3  2  1 -2 -2 -2 -2  1  2  2  3  4  5  
8  7  6  5  4  3  2  1 -2 -2 -2 -2  1  1  2  3  4  
9  8 -1  6  5  4  3  2  1  1 -2 -2 -2 -2  1  2  3  
10 9 -1 -1 -1  5  4  3  2  2  1  1  1 -2 -2  1  2  
11 10 -1  8  7  6  5  4  3  3  2  1 -2 -2  1  2  3  
12 11 -1 -1 -1 -1 -1  5  4  4  3  2  1 -2 -2  1  2  
13 12 11 10 9  8  7  6  5  4  3  2  1 -2 -2  1  2  
14 13 12 11 10 9  8  7  6  5  4  3  2  1  1  2  3  
15 14 13 12 11 10 9  8  7  6  5  4  3  2  2  3  4  
SIZE_F_X: 2
SIZE_F_Y: 2
**
.*
11 6
SYMBL: -1
X: 15
Y: 17
10 9  8  7  6  5  4  5  5  5  6  7  8  8  9 10 11 
9  8  7  6  5  4  3  4  4  4  5  6  7  7  8  9 10 
8  7  6  5  4  3  2  3  3  3  4  5  6  6  7  8  9  
7  6  5  4  3  2  1  2  2  2  3  4  5  5  6  7  8  
6  5  4  3  2  1 -2  1  1  1  2  3  4  4  5  6  7  
6  5  4  3  2  1 -2 -2 -2 -2  1  2  3  3  4  5  6  
7  6  5  4  3  2  1 -2 -2 -2 -2  1  2  2  3  4  5  
8  7  6  5  4  3  2  1 -2 -2 -2 -2  1  1  2  3  4  
9  8 -1  6  5  4  3  2  1  1 -2 -2 -2 -2  1  2  3  
10 9 -1 -1 -1  5  4  3  2  2  1  1  1 -2 -2  1  2  
11 10 -1  8  7  6  5  4  3  3  2  1 -2 -2  1  2  3  
12 11 -1 -1 -1 -1 -1 -1  4  4  3  2  1 -2 -2  1  2  
13 12 13 12 11 10 9 -1  5  4  3  2  1 -2 -2  1  2  
14 13 12 11 10 9  8  7  6  5  4  3  2  1  1  2  3  
15 14 13 12 11 10 9  8  7  6  5  4  3  2  2  3  4  
SIZE_F_X: 2
SIZE_F_Y: 2
**
..
