SYMBL: x
X: 15
Y: 17
9  8  7  8  9 10 11 12 13 14 15 16 17 18 19 20 21 
8  7  6  7  8  9 10 11 12 13 14 15 16 17 18 19 20 
7  6  5  6  7  8  9 10 11 12 13 14 15 16 17 18 19 
6  5  4  5  6  7  8  9 10 11 12 13 14 15 16 17 18 
5  4  3  4  5  6  7  8  9 10 11 12 13 14 15 16 17 
4  3  2  3  4  5  6  7  8  9 10 11 12 13 14 15 16 
3  2  1  2  3  4  5  6  7  8  9 10 11 12 13 14 15 
2  1 -1  1  2  3  4  5  6  7  8  9 10 11 12 13 14 
2  1 -1  1  2  3  4  5  6  7  8  9 10 11 12 13 14 
3  2  1  2  3  4  5  6  7  8  9 10 11 12 13 14 15 
4  3  2  3  4  5  6  7  8  9 10 11 12 13 14 15 16 
5  4  3  4  5  6  7  8  9 10 11 12 13 14 15 16 17 
6  5  4  5  6  7  8  9 10 11 12 13 14 15 -2 17 18 
7  6  5  6  7  8  9 10 11 12 13 14 15 16 17 18 19 
8  7  6  7  8  9 10 11 12 13 14 15 16 17 18 19 20 
SIZE_F_X: 1
SIZE_F_Y: 2
**
